1,1,1,1,1,1,1,1,1,1,1,1,1,1,1,1
A,0,0,0,0,0,0,0,1,0,0,0,1,0,0,1
3,0,0,0,0,0,0,0,1,0,0,0,1,0,0,1
1,1,1,1,1,0,0,0,1,0,0,0,1,0,0,1
1,0,0,0,0,0,0,0,1,0,1,1,1,0,0,1
1,0,0,0,0,0,0,0,1,0,0,0,0,0,0,1
1,0,0,0,0,0,0,0,1,0,0,0,0,0,0,1
1,0,0,0,1,0,0,0,1,0,0,0,0,0,0,1
1,0,0,0,1,0,0,0,0,0,1,1,1,1,1,1
1,0,0,0,1,0,0,0,0,0,1,0,0,0,0,1
1,0,0,0,1,0,0,1,1,0,1,0,0,0,0,1
1,0,0,0,1,0,0,1,1,0,1,0,1,0,0,1
1,0,0,0,0,0,0,0,0,0,1,0,1,0,0,1
1,0,0,0,0,0,0,0,0,0,0,0,1,0,0,1
1,0,0,0,0,0,0,0,0,0,0,0,1,0,0,1
1,1,1,1,1,1,1,1,1,1,1,1,1,1,B,1
